[
  {
    "id": "1",
    "name": "서울시",
    "shape": "poly",
    "coords": [
      52, 72, 53, 76, 55, 81, 59, 82, 61, 85, 67, 83, 68, 87, 72, 84, 75, 82,
      76, 77, 78, 76, 77, 75, 72, 76, 72, 73, 75, 72, 72, 67, 71, 65, 68, 64,
      65, 66, 65, 69, 63, 68, 57, 72, 56, 73, 51, 71, 52, 72
    ],

    "fillColor": "rgba(255,255,255,0.5)",
    "strokeColor": "transparent",
    "src": "./map_img/seoul.png"
  },
  {
    "id": "2",
    "name": "경기도",
    "shape": "poly",
    "coords": [
      56, 27, 54, 31, 62, 33, 63, 36, 60, 41, 57, 40, 56, 44, 57, 44, 57, 46,
      55, 47, 52, 44, 47, 44, 51, 48, 51, 52, 49, 53, 48, 68, 53, 69, 54, 71,
      60, 69, 64, 67, 67, 63, 75, 67, 76, 72, 73, 74, 77, 74, 79, 76, 77, 80,
      75, 85, 68, 88, 65, 85, 57, 86, 55, 82, 51, 79, 51, 87, 47, 89, 49, 96,
      41, 94, 35, 97, 40, 103, 43, 105, 45, 108, 51, 105, 51, 111, 48, 117, 57,
      127, 72, 122, 80, 130, 94, 117, 104, 115, 104, 111, 110, 109, 112, 96,
      117, 89, 114, 84, 120, 80, 112, 76, 100, 71, 102, 55, 109, 51, 106, 47,
      100, 42, 96, 42, 97, 37, 88, 36, 86, 30, 81, 30, 80, 25, 77, 21, 70, 21,
      67, 24, 56, 26
    ],
    "fillColor": "rgba(255,255,255,0.5)",
    "strokeColor": "transparent"
  },
  {
    "id": "3",
    "name": "인천",
    "shape": "poly",
    "coords": [
      42, 70, 42, 77, 42, 82, 46, 86, 49, 86, 50, 81, 48, 78, 51, 76, 51, 70,
      47, 69, 48, 63, 45, 56, 37, 64, 40, 69, 40, 69
    ],
    "fillColor": "rgba(255,255,255,0.5)",
    "strokeColor": "transparent"
  },
  {
    "id": "4",
    "name": "충청남도",
    "shape": "poly",
    "coords": [
      52, 130, 49, 124, 47, 119, 37, 117, 33, 113, 31, 113, 31, 117, 32, 119,
      30, 119, 28, 117, 27, 115, 22, 116, 21, 118, 22, 119, 24, 120, 25, 122,
      25, 124, 21, 128, 16, 127, 19, 125, 18, 121, 15, 123, 11, 124, 12, 124,
      11, 127, 9, 128, 5, 133, 6, 135, 8, 133, 9, 134, 8, 134, 11, 135, 11, 136,
      10, 136, 11, 136, 10, 137, 8, 139, 13, 138, 15, 137, 15, 140, 14, 142, 15,
      144, 15, 147, 17, 145, 18, 143, 21, 145, 26, 144, 27, 143, 27, 149, 27,
      152, 27, 155, 26, 160, 28, 165, 29, 167, 28, 169, 28, 175, 28, 179, 27,
      182, 25, 183, 30, 185, 34, 190, 34, 194, 34, 191, 37, 196, 40, 197, 43,
      192, 48, 191, 49, 187, 51, 185, 56, 186, 60, 186, 62, 190, 63, 191, 73,
      191, 76, 190, 78, 190, 80, 193, 80, 197, 81, 199, 83, 198, 86, 199, 86,
      200, 89, 199, 92, 197, 95, 199, 96, 196, 97, 193, 94, 189, 94, 183, 91,
      182, 83, 184, 81, 179, 78, 183, 75, 178, 74, 175, 77, 169, 79, 163, 82,
      161, 82, 154, 79, 152, 78, 146, 80, 143, 86, 141, 88, 140, 84, 134, 81,
      131, 80, 128, 77, 126, 73, 124, 72, 123, 64, 125, 59, 125, 57, 127, 53,
      129, 53, 129, 51, 128
    ],

    "fillColor": "rgba(255,255,255,0.5)",
    "strokeColor": "transparent"
  },
  {
    "id": "5",
    "name": "강원도",
    "shape": "poly",
    "coords": [
      78, 21, 81, 23, 81, 26, 83, 31, 86, 30, 88, 28, 89, 30, 91, 35, 90, 36,
      96, 34, 97, 37, 97, 40, 98, 42, 104, 47, 108, 51, 106, 54, 101, 56, 101,
      59, 103, 71, 104, 72, 109, 74, 111, 76, 118, 80, 119, 81, 113, 85, 116,
      89, 112, 99, 111, 107, 113, 110, 122, 111, 122, 105, 128, 103, 130, 108,
      132, 110, 141, 107, 148, 110, 144, 111, 144, 112, 145, 115, 153, 113, 154,
      116, 159, 116, 171, 123, 177, 120, 179, 120, 181, 123, 182, 125, 185, 121,
      191, 122, 194, 122, 198, 121, 202, 127, 205, 122, 211, 118, 215, 116, 212,
      109, 204, 97, 194, 79, 195, 75, 182, 59, 182, 56, 175, 47, 168, 25, 160,
      2, 156, -1, 153, 1, 153, 11, 142, 21, 132, 21, 127, 19, 120, 20, 117, 17,
      104, 18, 100, 20, 97, 17, 89, 18, 85, 16, 78, 18, 77, 19
    ],

    "fillColor": "rgba(255,255,255,0.5)",
    "strokeColor": "transparent"
  },

  {
    "id": "6",
    "name": "충청남도",
    "shape": "poly",
    "coords": [
      52, 130, 49, 124, 47, 119, 37, 117, 33, 113, 31, 113, 31, 117, 32, 119,
      30, 119, 28, 117, 27, 115, 22, 116, 21, 118, 22, 119, 24, 120, 25, 122,
      25, 124, 21, 128, 16, 127, 19, 125, 18, 121, 15, 123, 11, 124, 12, 124,
      11, 127, 9, 128, 5, 133, 6, 135, 8, 133, 9, 134, 8, 134, 11, 135, 11, 136,
      10, 136, 11, 136, 10, 137, 8, 139, 13, 138, 15, 137, 15, 140, 14, 142, 15,
      144, 15, 147, 17, 145, 18, 143, 21, 145, 26, 144, 27, 143, 27, 149, 27,
      152, 27, 155, 26, 160, 28, 165, 29, 167, 28, 169, 28, 175, 28, 179, 27,
      182, 25, 183, 30, 185, 34, 190, 34, 194, 34, 191, 37, 196, 40, 197, 43,
      192, 48, 191, 49, 187, 51, 185, 56, 186, 60, 186, 62, 190, 63, 191, 73,
      191, 76, 190, 78, 190, 80, 193, 80, 197, 81, 199, 83, 198, 86, 199, 86,
      200, 89, 199, 92, 197, 95, 199, 96, 196, 97, 193, 94, 189, 94, 183, 91,
      182, 83, 184, 81, 179, 78, 183, 75, 178, 74, 175, 77, 169, 79, 163, 82,
      161, 82, 154, 79, 152, 78, 146, 80, 143, 86, 141, 88, 140, 84, 134, 81,
      131, 80, 128, 77, 126, 73, 124, 72, 123, 64, 125, 59, 125, 57, 127, 53,
      129, 53, 129, 51, 128
    ],

    "fillColor": "rgba(255,255,255,0.5)",
    "strokeColor": "transparent"
  },
  {
    "id": "7",
    "name": "충청북도",
    "shape": "poly",
    "coords": [
      81, 131, 84, 135, 88, 139, 85, 142, 79, 145, 80, 147, 79, 154, 82, 159,
      81, 164, 76, 168, 75, 176, 79, 184, 81, 179, 84, 185, 91, 182, 95, 183,
      96, 192, 101, 198, 108, 200, 114, 200, 121, 192, 122, 187, 125, 185, 123,
      181, 117, 181, 112, 178, 116, 172, 116, 160, 111, 155, 116, 152, 119, 153,
      120, 149, 117, 147, 125, 145, 130, 145, 129, 140, 138, 138, 142, 136, 146,
      139, 151, 141, 154, 139, 152, 134, 157, 128, 165, 123, 167, 121, 159, 118,
      153, 116, 148, 114, 143, 114, 144, 113, 149, 109, 142, 108, 140, 105, 135,
      107, 129, 108, 127, 104, 124, 102, 119, 107, 118, 110, 111, 109, 104, 110,
      81, 131
    ],

    "fillColor": "rgba(255,255,255,0.5)",
    "strokeColor": "transparent"
  },
  {
    "id": "8",
    "name": "경상북도",
    "shape": "poly",
    "coords": [
      215, 119, 212, 122, 216, 125, 216, 141, 219, 149, 213, 164, 216, 168, 215,
      177, 210, 183, 211, 198, 213, 201, 210, 206, 212, 210, 220, 204, 217, 206,
      220, 204, 214, 238, 207, 234, 200, 236, 197, 235, 197, 230, 189, 230, 185,
      237, 177, 235, 165, 240, 153, 237, 139, 233, 128, 229, 130, 224, 129, 221,
      120, 215, 111, 209, 113, 205, 110, 199, 117, 196, 118, 191, 120, 187, 125,
      187, 123, 182, 119, 181, 113, 179, 116, 173, 116, 167, 116, 160, 111, 156,
      115, 152, 119, 152, 117, 148, 125, 144, 128, 146, 128, 139, 135, 138, 140,
      135, 147, 140, 152, 140, 153, 135, 158, 128, 166, 123, 172, 124, 177, 120,
      183, 126, 186, 121, 192, 123, 194, 120, 200, 124, 203, 126, 207, 120
    ],

    "fillColor": "rgba(255,255,255,0.5)",
    "strokeColor": "transparent",
    "src": "./map_img/gyeongbuk.png"
  },
  {
    "id": "9",
    "name": "경상남도",
    "shape": "poly",
    "coords": [
      108, 213, 96, 218, 92, 236, 94, 238, 94, 246, 90, 250, 91, 255, 93, 265,
      100, 276, 99, 281, 94, 284, 100, 289, 100, 284, 106, 286, 112, 282, 115,
      283, 118, 278, 118, 287, 126, 291, 129, 288, 135, 288, 134, 291, 137, 293,
      138, 294, 135, 297, 143, 304, 145, 296, 144, 290, 141, 289, 144, 284, 147,
      281, 146, 276, 151, 277, 155, 281, 154, 270, 164, 278, 173, 280, 178, 278,
      178, 283, 185, 282, 196, 271, 201, 262, 206, 259, 208, 251, 213, 250, 216,
      238, 205, 234, 198, 235, 195, 234, 197, 231, 188, 230, 185, 237, 176, 234,
      165, 240, 128, 229, 130, 222, 123, 215, 111, 209, 101, 215
    ],

    "fillColor": "rgba(255,255,255,0.5)",
    "strokeColor": "transparent"
  },
  {
    "id": "10",
    "name": "전라북도",
    "shape": "poly",
    "coords": [
      39, 198, 25, 198, 31, 202, 32, 205, 45, 204, 43, 207, 36, 208, 42, 214,
      33, 213, 28, 219, 20, 224, 21, 227, 32, 228, 30, 230, 21, 232, 17, 238,
      21, 248, 31, 248, 36, 242, 36, 234, 42, 237, 49, 246, 53, 239, 55, 242,
      54, 250, 59, 252, 65, 250, 76, 254, 81, 250, 90, 253, 90, 249, 94, 244,
      93, 238, 90, 235, 96, 216, 112, 206, 110, 200, 100, 198, 95, 195, 94, 200,
      90, 197, 88, 202, 82, 198, 78, 198, 79, 189, 62, 191, 59, 185, 51, 185,
      44, 194, 39, 194, 39, 195
    ],

    "fillColor": "rgba(255,255,255,0.5)",
    "strokeColor": "transparent"
  },
  {
    "id": "11",
    "name": "전라남도",
    "shape": "poly",
    "coords": [
      10, 307, 13, 316, 15, 318, 11, 319, 14, 326, 20, 326, 23, 319, 30, 317,
      33, 307, 34, 317, 41, 319, 48, 314, 48, 305, 61, 300, 67, 296, 70, 298,
      68, 302, 61, 302, 61, 307, 54, 311, 64, 317, 67, 322, 77, 314, 81, 309,
      75, 301, 75, 295, 81, 291, 85, 296, 84, 304, 88, 309, 91, 301, 100, 302,
      100, 290, 89, 290, 88, 286, 95, 285, 94, 283, 99, 279, 99, 275, 92, 266,
      91, 252, 82, 249, 75, 254, 64, 250, 58, 252, 52, 249, 55, 242, 53, 239,
      50, 245, 41, 236, 36, 233, 36, 242, 32, 248, 21, 247, 17, 237, 11, 247, 4,
      253, 12, 259, 14, 263, 13, 266, 8, 264, 8, 270, 3, 275, 9, 278, 6, 289,
      -1, 292, 1, 302, 1, 302
    ],

    "fillColor": "rgba(255,255,255,0.5)",
    "strokeColor": "transparent"
  },
  {
    "id": "jeju",
    "name": "제주도",
    "shape": "poly",
    "coords": [
      20, 354, 24, 362, 43, 363, 64, 361, 75, 349, 69, 342, 61, 338, 35, 341,
      21, 353
    ],

    "fillColor": "rgba(255,255,255,0.5)",
    "strokeColor": "transparent",

    "src": "./map_img/jeju.png"
  }
]
